NO textures/north.xpm
SO textures/south.xpm
WE textures/west.xpm
EA textures/east.xpm
F 50,50,50
C 200,200,200
111111111111111111111111111111
1000000000111000000000000000011
1111000000000000111000000000111
1000000000000000000000000000011
1000000000000000000000000000011
111111111111111111111111111111
1000000000000000000000000000011
1000000000000000000000000000011
1000000000000000000000000000011
111111111111111111111111111111
1000000000000000000000000000011
1000000000000000000000000000011
1000000000000000000000000000011
1000000000000000000000000000011
111111111111111111111111111111
1E10000000000000000000000000001
111111111111111111111111111111