NO textures/north.xpm
SO textures/south.xpm
WE textures/west.xpm
EA textures/east.xpm
C 125,200,255
F 170,255,200
111111111111111111111111111111111
100100000000000000101010111000001
101000001000000000011000011010011
110001110000000000011111000001001
110001110000000000011111000001001
11000111000000N000000011000001001
100100000000000000101010111000001
100100000000000000101010111000001
100000000000000111100000000000111
100000000000000000000000000000001
100000000000000000100000000000001
111111111111111111111111111111111