F 220,100,0
C 225,30,0

       1111111111111111111111111
      1000000000111000000000001
      1111000000000000111000001
      1000000000000000000000001
      1000000000000000000000001
      1111111111111111111111111
      1000000000000000000000001
      1000000000000000000000001
      1000000000000000000000001
      1111111111111111111111111
      1000000000000000000000001
      1000000000000000000000001
      1000000000000000000000001
      1000000000000000000000001
      1111111111111111111111111
      1E1000000000000000000000001
      1111111111111111111111111
EOF