111111
1P0C1  <--
100E01
111111
