111111
1P0C11
100E00  <-- 
111111
