1111111111
10001P0001
10C1111C01
1000E00001
1C111111C1
1000000001
1111111111
