111111111111111
1P00000C00000E1
101111101111101
1C00000000000C1
111111111111111
