111111111
1P00C0001
101111101
1C00000C1
1000E0001
111111111
