11111111111111111111111111111111111
1E00000C0000000000000C00000C00000P1
10100100101001C01010010010100100101
1C10010010100100101001001C100100101
100000000C00000000000000000000000C1
11111111111111111111111111111111111
