1111111
1P0C0C1
10000E1
1111111
