1111111
1P01C01
1001001
10C00E1
1111111
