11111111
1P1E1C11
10101001
10001001
1C1010C1
11111111
