1111111111
1P00C000E1
1011101101
1C001000C1
1111111111
