11111111111
1P1C1C1C1E1
10101010101
10101010101
10101010101
10000000001
11111111111
